###                   #########
#   #####################   # #
# ###                   # # # #
# ##################### # # # #
#                       # # # #
####################### # # # #
#   ##                  # # # #
# # ## ### ## ########### # # #
# #    #   ##B#           # # #
# # ## ################## # # #
### ##               #### # # #
### ################ ## # # # #
###               ##    # # # #
###### ########## ####### # # #
###### ####               #   #
A      ########################